|||||||||||||||||||||||||||
|                         |
|                         |
|___     J                |
|                         |
|                         |
|             <<>>     S  |
|                         |
| =======    F            |
|                         |
|         >>>       <<<   |
|                         |
|                         |
|                     ^^^^|
___________________________