###########################
#                         #
#                         #
#                         #
#                         #
#                         #
#       <<                #
#                         #
#                  ===    #
#                         #
#        >>>              #
#                   ^     #
#                         #
#                         #
___________________________