||||||||||||||||||||||||||||||||||||||||||||||||||||||||||||||||||||||||||||||||||||
|                                                                                  |
|                                                                                  |
|                                                                                  |
|                                                                                  |
|                                                                                  |
|                                                                                  |
|                                                                                  |
|                                 |                                                |
|                                 |      |                                         |
|                   ||         |||||||||||||||                                     |
|                                    |                                             |
|                                    |                                             |
|          ||                        |                                             |
|                       ||||   ||||  |                                             |
|                                    |                                             |
|      ||                            |                                             |
|                          |||||||||||                                             |
|                      |||||                                                       |
|  ||           ||||||||                                                           |
|                      |                                                           |
|      ||              |                                                           |
|      |               |                                                           |
|      |               |                                                           |
|      ||||||||     ||||                                                           |
|                      |                                                           |
|                      |                                                           |
|            |||||^|||||                                                           |
|            |                                                                     |
||||||||||||||                                                                     |
|                                                                                  |
|                                                                                  |
|                                                                                  |
|                                                                                  |
|                                                                                  |
|                                                                                  |
|                                                                                  |
|                 =                                                                |
____________________________________________________________________________________