|||||||||||||||||||||||||||||||||||||||||||||||||||||||||||||||||||||||||||||||||
|                                                                               |
|                                                                               |
|                                                                               |
|                                                                               |
|                                                                               |
|                                                                               |
|                                                                               |
|                                                                               |
|                                                                               |
|                                                                               |
|       <<                                                                      |
|                                                                               |
|                  ===                                                          |
|                                                                               |
|        >>>                                                                    |
|                   ^                                                           |
|                                                                               |
|                                                                               |
_______________________________________________________                         |
++++++++++++++++++++++++++++++++++++++++++++++++++++++|                         |
++++++++++++++++++++++++++++++++++++++++++++++++++++++|                         |
++++++++++++++++++++++++++++++++++++++++++++++++++++++|                         |
++++++++++++++++++++++++++++++++++++++++++++++++++++++|                         |
++++++++++++++++++++++++++++++++++++++++++++++++++++++|                         |
++++++++++++++++++++++++++++++++++++++++++++++++++++++|^^^^^^^^^^^^^^^^^^^^^^^^^|
++++++++++++++++++++++++++++++++++++++++++++++++++++++|_________________________|