######################################################
#                                                    #
#                                                    #
#                                                    #
#                                                    #
#       <<                                           #
#                                                    #
#                  ===                               #
#                                                    #
#        >>>                                         #
#                   ^                                #
#                                                    #
#   #                                                #
______________________________________________________