||||||||||||||||||||||||||||||||||||||||||||||||||||||
|                                                    |
|                                                    |
|                                                    |
|                                                    |
|                                                    |
|                                                    |
|                                                    |
|                                                    |
|                                                    |
|                                                    |
|       <<                                           |
|                                                    |
|                  ===                               |
|                                                    |
|        >>>                                         |
|                   ^                                |
|                                                    |
|   |                                                |
______________________________________________________ 