||||||||||||||||||||||||||||||||||||||||||||||||||||||||||||||||||||||||||||||||||||
|                                                                                  |
|                                                                                  |
|                                                                                  |
|                                                                                  |
|                                                                                  |
|                                                                                  |
|                                                                                  |
|                                 |                                                |
|                                 |      |                                         |
|                   --         ---------------                                     |
|                                    |                                             |
|                                    |                                             |
|          --                        |                                             |
|                       ----   ----  |                                             |
|                                    |                                             |
|      --                            |                                             |
|                          -----------                                             |
|                      ----|                                                       |
|  --           -------|                                                           |
|                      |                                                           |
|      --              |                                                           |
|      |               |                                                           |
|      |               |                                                           |
|      --------     ---|                                                           |
|                      |                                                           |
|                      |                                                           |
|            -----^-----                                                           |
|            |                                                                     |
|-------------                                                                     |
|                                                                                  |
|                                                                                  |
|                                                                                  |
|                                                                                  |
|                                                                                  |
|                                                                                  |
|                                                                                  |
|                 =                                                                |
____________________________________________________________________________________